%%%%%%%%%%%%%%%%%%%%%%%%%%%%%%%%%%%%
%    ...        ..................P%
% %%%%%%%%%%%%%%.%%%%%%%% %%%%%%%% %
% %%   %   %..... %%%%%%%   %%     %
% %% % % % %.%%%%%%%%%%%%%% %% %%%%%
% %% % % % %........     %% %%     %
% %% % % % % % %%%%..%%%..  %%%%%% %
% %%%%%% %   %    %%.%%%%%%%%      % 
% %% % % %%%%%%%% %%........%% %%%%%
% %% %   %%       %%%%%%%%%.%%     %
%    %%%%%% %%%%%%%  ... %%.%%%%%% %
%%%%%%      %       %%%% %%.       %
%      %%%%%% %%%%% %    % . % %%%%%
% %%%%%%      %       ..%%%.%%     %
%       ... %%% %%%%....%%%.%%  %% %
%%%%%%%%%%%%%          . ...%%%%%% %
%.         %%%....%%%%%...%        %
%%%%%%%%%%%%%%%%%%%%%%%%%%%%%%%%%%%%